"filename", "language", "C++", "Ini", "comment", "blank", "total"
"/Users/carlwgreenstreet/Documents/PlatformIO/Projects/cloudSmoker/cloudSmoker_nodeMCU_12E_V1-0/lib/helper_functions/helper_functions.cpp", "C++", 10, 0, 14, 6, 30
"/Users/carlwgreenstreet/Documents/PlatformIO/Projects/cloudSmoker/cloudSmoker_nodeMCU_12E_V1-0/lib/helper_functions/helper_functions.h", "C++", 14, 0, 10, 6, 30
"/Users/carlwgreenstreet/Documents/PlatformIO/Projects/cloudSmoker/cloudSmoker_nodeMCU_12E_V1-0/lib/lcd/lcd.cpp", "C++", 393, 0, 78, 53, 524
"/Users/carlwgreenstreet/Documents/PlatformIO/Projects/cloudSmoker/cloudSmoker_nodeMCU_12E_V1-0/lib/lcd/lcd.h", "C++", 41, 0, 25, 16, 82
"/Users/carlwgreenstreet/Documents/PlatformIO/Projects/cloudSmoker/cloudSmoker_nodeMCU_12E_V1-0/lib/periphials/periphials.cpp", "C++", 12, 0, 17, 5, 34
"/Users/carlwgreenstreet/Documents/PlatformIO/Projects/cloudSmoker/cloudSmoker_nodeMCU_12E_V1-0/lib/periphials/periphials.h", "C++", 18, 0, 16, 9, 43
"/Users/carlwgreenstreet/Documents/PlatformIO/Projects/cloudSmoker/cloudSmoker_nodeMCU_12E_V1-0/lib/press_type/press_type.cpp", "C++", 65, 0, 27, 15, 107
"/Users/carlwgreenstreet/Documents/PlatformIO/Projects/cloudSmoker/cloudSmoker_nodeMCU_12E_V1-0/lib/press_type/press_type.h", "C++", 28, 0, 23, 13, 64
"/Users/carlwgreenstreet/Documents/PlatformIO/Projects/cloudSmoker/cloudSmoker_nodeMCU_12E_V1-0/lib/smokerStates/smokerStates.cpp", "C++", 127, 0, 54, 33, 214
"/Users/carlwgreenstreet/Documents/PlatformIO/Projects/cloudSmoker/cloudSmoker_nodeMCU_12E_V1-0/lib/smokerStates/smokerStates.h", "C++", 22, 0, 15, 8, 45
"/Users/carlwgreenstreet/Documents/PlatformIO/Projects/cloudSmoker/cloudSmoker_nodeMCU_12E_V1-0/lib/wrapEncoder/wrapEncoder.cpp", "C++", 75, 0, 16, 13, 104
"/Users/carlwgreenstreet/Documents/PlatformIO/Projects/cloudSmoker/cloudSmoker_nodeMCU_12E_V1-0/lib/wrapEncoder/wrapEncoder.h", "C++", 31, 0, 22, 13, 66
"/Users/carlwgreenstreet/Documents/PlatformIO/Projects/cloudSmoker/cloudSmoker_nodeMCU_12E_V1-0/platformio.ini", "Ini", 0, 11, 13, 3, 27
"/Users/carlwgreenstreet/Documents/PlatformIO/Projects/cloudSmoker/cloudSmoker_nodeMCU_12E_V1-0/src/cloudSmoker_nodeMCU_main.cpp", "C++", 50, 0, 111, 25, 186
"Total", "-", 886, 11, 441, 218, 1556