"filename", "language", "C++", "Ini", "comment", "blank", "total"
"/Users/carlwgreenstreet/Documents/PlatformIO/Projects/cloudSmoker/cloudSmoker_nodeMCU_12E_V1-0/lib/helper_functions/helper_functions.cpp", "C++", -10, 0, -14, -6, -30
"/Users/carlwgreenstreet/Documents/PlatformIO/Projects/cloudSmoker/cloudSmoker_nodeMCU_12E_V1-0/lib/helper_functions/helper_functions.h", "C++", -14, 0, -10, -6, -30
"/Users/carlwgreenstreet/Documents/PlatformIO/Projects/cloudSmoker/cloudSmoker_nodeMCU_12E_V1-0/lib/lcd/lcd.cpp", "C++", -486, 0, -102, -55, -643
"/Users/carlwgreenstreet/Documents/PlatformIO/Projects/cloudSmoker/cloudSmoker_nodeMCU_12E_V1-0/lib/lcd/lcd.h", "C++", -41, 0, -27, -19, -87
"/Users/carlwgreenstreet/Documents/PlatformIO/Projects/cloudSmoker/cloudSmoker_nodeMCU_12E_V1-0/lib/periphials/periphials.cpp", "C++", -12, 0, -17, -5, -34
"/Users/carlwgreenstreet/Documents/PlatformIO/Projects/cloudSmoker/cloudSmoker_nodeMCU_12E_V1-0/lib/periphials/periphials.h", "C++", -18, 0, -16, -9, -43
"/Users/carlwgreenstreet/Documents/PlatformIO/Projects/cloudSmoker/cloudSmoker_nodeMCU_12E_V1-0/lib/press_type/press_type.cpp", "C++", -65, 0, -27, -15, -107
"/Users/carlwgreenstreet/Documents/PlatformIO/Projects/cloudSmoker/cloudSmoker_nodeMCU_12E_V1-0/lib/press_type/press_type.h", "C++", -28, 0, -23, -13, -64
"/Users/carlwgreenstreet/Documents/PlatformIO/Projects/cloudSmoker/cloudSmoker_nodeMCU_12E_V1-0/lib/smokerStates/smokerStates.cpp", "C++", -178, 0, -66, -44, -288
"/Users/carlwgreenstreet/Documents/PlatformIO/Projects/cloudSmoker/cloudSmoker_nodeMCU_12E_V1-0/lib/smokerStates/smokerStates.h", "C++", -22, 0, -15, -8, -45
"/Users/carlwgreenstreet/Documents/PlatformIO/Projects/cloudSmoker/cloudSmoker_nodeMCU_12E_V1-0/lib/wrapEncoder/wrapEncoder.cpp", "C++", -75, 0, -16, -13, -104
"/Users/carlwgreenstreet/Documents/PlatformIO/Projects/cloudSmoker/cloudSmoker_nodeMCU_12E_V1-0/lib/wrapEncoder/wrapEncoder.h", "C++", -31, 0, -22, -13, -66
"/Users/carlwgreenstreet/Documents/PlatformIO/Projects/cloudSmoker/cloudSmoker_nodeMCU_12E_V1-0/platformio.ini", "Ini", 0, -11, -13, -3, -27
"/Users/carlwgreenstreet/Documents/PlatformIO/Projects/cloudSmoker/cloudSmoker_nodeMCU_12E_V1-0/src/cloudSmoker_nodeMCU_main.cpp", "C++", -50, 0, -111, -25, -186
"/home/carl/Documents/Electronics/PlatformIO/cloudSmoker/cloudSmoker/cloudSmoker_nodeMCU_12E_V1-0/lib/cwg_ads1x15/cwg_ads1x15.cpp", "C++", 67, 0, 33, 14, 114
"/home/carl/Documents/Electronics/PlatformIO/cloudSmoker/cloudSmoker/cloudSmoker_nodeMCU_12E_V1-0/lib/cwg_ads1x15/cwg_ads1x15.h", "C++", 25, 0, 36, 10, 71
"/home/carl/Documents/Electronics/PlatformIO/cloudSmoker/cloudSmoker/cloudSmoker_nodeMCU_12E_V1-0/lib/helper_functions/helper_functions.cpp", "C++", 10, 0, 14, 6, 30
"/home/carl/Documents/Electronics/PlatformIO/cloudSmoker/cloudSmoker/cloudSmoker_nodeMCU_12E_V1-0/lib/helper_functions/helper_functions.h", "C++", 14, 0, 10, 6, 30
"/home/carl/Documents/Electronics/PlatformIO/cloudSmoker/cloudSmoker/cloudSmoker_nodeMCU_12E_V1-0/lib/lcd/lcd.cpp", "C++", 533, 0, 90, 59, 682
"/home/carl/Documents/Electronics/PlatformIO/cloudSmoker/cloudSmoker/cloudSmoker_nodeMCU_12E_V1-0/lib/lcd/lcd.h", "C++", 41, 0, 27, 19, 87
"/home/carl/Documents/Electronics/PlatformIO/cloudSmoker/cloudSmoker/cloudSmoker_nodeMCU_12E_V1-0/lib/periphials/periphials.cpp", "C++", 12, 0, 17, 5, 34
"/home/carl/Documents/Electronics/PlatformIO/cloudSmoker/cloudSmoker/cloudSmoker_nodeMCU_12E_V1-0/lib/periphials/periphials.h", "C++", 18, 0, 16, 9, 43
"/home/carl/Documents/Electronics/PlatformIO/cloudSmoker/cloudSmoker/cloudSmoker_nodeMCU_12E_V1-0/lib/press_type/press_type.cpp", "C++", 65, 0, 27, 15, 107
"/home/carl/Documents/Electronics/PlatformIO/cloudSmoker/cloudSmoker/cloudSmoker_nodeMCU_12E_V1-0/lib/press_type/press_type.h", "C++", 28, 0, 23, 13, 64
"/home/carl/Documents/Electronics/PlatformIO/cloudSmoker/cloudSmoker/cloudSmoker_nodeMCU_12E_V1-0/lib/smokerStates/smokerStates.cpp", "C++", 261, 0, 47, 58, 366
"/home/carl/Documents/Electronics/PlatformIO/cloudSmoker/cloudSmoker/cloudSmoker_nodeMCU_12E_V1-0/lib/smokerStates/smokerStates.h", "C++", 22, 0, 15, 8, 45
"/home/carl/Documents/Electronics/PlatformIO/cloudSmoker/cloudSmoker/cloudSmoker_nodeMCU_12E_V1-0/lib/wrapEncoder/wrapEncoder.cpp", "C++", 75, 0, 16, 12, 103
"/home/carl/Documents/Electronics/PlatformIO/cloudSmoker/cloudSmoker/cloudSmoker_nodeMCU_12E_V1-0/lib/wrapEncoder/wrapEncoder.h", "C++", 31, 0, 22, 13, 66
"/home/carl/Documents/Electronics/PlatformIO/cloudSmoker/cloudSmoker/cloudSmoker_nodeMCU_12E_V1-0/platformio.ini", "Ini", 0, 13, 9, 2, 24
"/home/carl/Documents/Electronics/PlatformIO/cloudSmoker/cloudSmoker/cloudSmoker_nodeMCU_12E_V1-0/src/cloudSmoker_nodeMCU_main.cpp", "C++", 76, 0, 165, 36, 277
"Total", "-", 248, 2, 88, 51, 389